AFFIRMATIVE	AH F ER M AH T IH V
BACK	B AE K
CONFIRM	K AH N F ER M
DEGREES	D IH G R IY Z
EIGHT	EY T
FIVE	F AY V
FORTY_FIVE	F AO R T IY F AY V
FORWARD	F AO R W ER D
FOUR	F AO R
LEFT	L EH F T
MARK	M AA R K
METER	M IY T ER
NEGATIVE	N EH G AH T IH V
NINE	N AY N
NINETY	N AY N T IY
ONE	W AH N
ONE(2)	HH W AH N
RIGHT	R AY T
ROTATE	R OW T EY T
SECONDS	S EH K AH N D Z
SEVEN	S EH V AH N
SIX	S IH K S
SIXTY	S IH K S T IY
TEN	T EH N
THIRTY	TH ER D IY
THREE	TH R IY
TWO	T UW
